1111311
1111111
1131311
1111222
1111111
1111111
1111111
