111111111111111111111
111122222222222211111
111121111111111211111
111121111111111211111
111121111111111211111
111121111111111211111
111121111111111211111
111121111111111211111
111111111111111111111
111111111111111111111
111111111111111111111
