111111111111111111111
111122222222222211111
111123333333333211111
111123111111113211111
111123111111113211111
111123111111113211111
111123111111113211111
111123111111113211111
111111111111111111111
111111111111111111111
111111111111111111111
